.....P......
.O.......T..
D.P...U.....
.......d....
.....T....P.
U..P........
.......P....
.D.........T
.....R......
P.........P.
....T......O
X......P.U..