............
.O...T....T.
..D...U.....
.......P.O..
...P........
U......d....
....P....P..
.D....T.U...
...T........
P.....d....P
....P.......
X.......P..O